[info]
music=level
bg=1

[easy]
0 = 0,0,0,0,0,0,0,0,0,0,0,0,0,0,0,0
1 = 0,0,0,0,0,0,0,0,0,0,0,0,0,0,0,0
2 = 0,0,0,0,0,0,0,0,0,0,0,0,0,0,0,0
3 = 0,0,0,0,0,0,0,0,0,0,0,0,0,0,0,0

[medium]
0 = 0,0,0,0,0,0,0,1,1,0,0,0,0,0,0,0
1 = 0,0,0,0,0,0,1,2,2,1,0,0,0,0,0,0
2 = 0,0,0,0,0,1,2,3,3,2,1,0,0,0,0,0
3 = 0,0,0,0,0,0,1,2,2,1,0,0,0,0,0,0
4 = 0,0,0,0,0,0,0,1,1,0,0,0,0,0,0,0

[hard]
0 = 3,3,3,3,3,3,3,3,3,3,3,3,3,3,3,3
1 = 2,2,2,2,2,2,2,2,2,2,2,2,2,2,2,2
2 = 1,1,1,1,2,2,2,2,2,2,2,2,1,1,1,1
3 = 0,0,1,1,1,1,1,2,2,1,1,1,1,1,0,0
4 = 0,0,0,0,0,0,1,1,1,1,0,0,0,0,0,0
5 = 0,0,0,0,0,0,0,0,0,0,0,0,0,0,0,0

[insane]
0 = 3,3,3,3,3,3,3,3,3,3,3,3,3,3,3,3
1 = 3,3,3,3,3,3,3,3,3,3,3,3,3,3,3,3
2 = 3,3,3,3,3,3,3,3,3,3,3,3,3,3,3,3
3 = 3,3,3,3,3,3,3,3,3,3,3,3,3,3,3,3
4 = 3,3,3,3,3,3,3,3,3,3,3,3,3,3,3,3
5 = 3,3,3,3,3,3,3,3,3,3,3,3,3,3,3,3
